####################
#S......#........G#
#..####.#.####..#.#
#..#.......#.....#.#
#..#..##..##..#..#.#
#...............#.#
####################
